#############
#CB.........#
###.#.#.#.###
  #.#D#.#.#
  #.#C#.#.#
  #A#B#.#.#
  #########